    The Great Temple of Yavin 4 served as a Rebel base around the time of the Battle of Yavin.  
The Alliance to Restore the Republic had several bases:

Canon
Pre-Alliance
Atollon – Chopper Base located on the Atollon Coral Mesa
Havoc Outpost
Paucris Major – Paucris Major Shipyards
Rebel Alliance
5251977
Bayora - Bayora rebel base
Cassidode VI – Cassidode VI rebel outpost
Crait – Crait outpost
Dantooine – Dantooine base
D'Qar – Resistance base
Durkteel – Tak-Beam complex
Hope Station
Horox III – Horox III rebel outpost
Hoth – Echo Base, Echo Station 3-T-8, Outpost Beta and Perimeter Outpost Delta
Mako-Ta Space Docks
Primtara – Primtara outpost
Reamma – LX-Robynsun V
Talrezan Four
Tierfon Launch Base
Unroola Dawn
Vrogas Vas – Rebel Refueling Base
Yavin 4 – Great Temple
Legends
Ground bases
Core Worlds ground bases
Corellia – Hidden Rebel Base
Pkihantri – Rebel base
Talus – Rebel Forward Base Camp and Talus base
Xyquine II – Xyquine base
Colonies ground bases
AX-456 – Rebel base
Dankayo – Dankayo Base
Laakteen – Laakteen Depot
Teardrop – Teardrop rebel base
Inner Rim ground bases
Dalastine – Dalastine Rebel base
Datar – Unidentified Rebel Alliance base
Ketal – Rebel base
Laertos – Drop point
M132L4 system – Condor
Thyferra – Alliance Comms Center
Expansion Region ground bases
Annamar – Abandoned droid factory
Edan II – Edan Base
Farstey – Rebel starfighter base
Karatha – Eyrie Base
Obas – Obas Rebel Alliance base
Tel III – Oracle Base
Tierfon – Tierfon Rebel Outpost
Mid Rim ground bases
Aargonar 3 – Aargonar 3 rebel base
Bothawui – Rebel safehouse
Boz Pity – Boz Pity base
Bundim – Bundim Rebel Base
Cataalda – Cataalda outpost
Derricon – Unidentified Alliance base
Ebenmal – Citadel of Ebenmal
Elbara Nine – GlitterFall Base
Entrus – Trax Sector Command
Homon – Rebel starfighter base
Kashyyyk – Rebel camp
Kholes – Rebel outpost
Krant – Ghost Base
Mapuzo – Rebel base
Naboo – Naboo Rebel hangar
Nentan – Rebel base
Ord Pardron – Ord Pardron sector defense outpost
Qetix IV – Qetix IV Alliance base
Roche asteroid field – Command Base
Rori – Rebel Base, Rebel Base and Zephyr Base
Talay – Tak Base
Tomark II – Chiron Base
Outer Rim ground bases
Akuria II – Akuria Rebel Base
Arbra – Haven Base
Arda-1 – Arda I Rebel base
Asher III – Rebel base
Barkhesh – Rebel Base
Baskarn – Advance Base Baskarn
Berrol's Donn – The Donn
Bid'jerma – Outpost Cinder
Cardooine – Rebel base
Cathis – Cathis Rebel starfighter base
Choah Belt – Fuel refinery
Chrellis – Chrellis Base
Cron Drift – AX-235
Dantooine – Dantooine base and Rebel outpost
Dathomir – Rebel hangar
Endor – Endor Station
Fangol – Mortex Sector HQ
Gaulus – Alliance Base 16
Gelgelar – Drop Point Gelgelar
Generis – Generis base
Golrath – Golrath Station
Hoth – Echo Base, several Echo Stations, Gamma Base, Outpost Beta and Wampa Valley base
Jagomir – Resolute Base
Karinda – Karinda Outpost
Kile – Rebel base
Kolaador – Kolaador Base
Korseg IV – Flare Base
Ksift – Alliance Training Center-5/Green Squad
Lan Barell – Rebel weapons depot
Laramus – Laramus Base
Liintaar system – Liintaar Station
Mygeeto – Rebel outpost
New Kisge – Delta Base
Nishr – Nishr Base Three, Nishr Base Seven and Nishr Base Ten
Outer Rim Territories – Unidentified Rebel Alliance training base
Picutorion – Tracking station
Polis Massa – Polis Massa Research Base
Randa – Randa Rebel base
Refnar – Unidentified Alliance base
Reginard – Reginard Base
Rentean – Rentean shipbuilding facility
Risban – Fortress Keremark
Second moon of Tiragga – Tiragga Alliance outpost
Seven Flames – Unidentified Rebel base
Sinjan – Sinjan Outpost
Spefik – Spefik base
Sran system – Sran Outpost
Sullust system – Keff Base
Tatooine – Anchorhead Base and Rebel Military Base
Taul – Rebel outpost
Thila – Thila Command
Triton system – Defiant Core
Turak IV – Uratai Basin Base
Unidentified Corva sector planet – Titan Base
Vergesso Asteroids – Vergesso Base
Yavin 4 – Falcon Base, Great Temple, Raven Base and Rebel outpost
Hutt Space ground bases
Arrochar – Arrochar Rebel base
Other ground bases
Ahlenn – Unidentified Rebel base
Aracara – DVL-181
Fandélane – Fandélane Rebel base
Orflon – Asteroid Base
Radra IV – Radra Surveillance Post
Yukka – The Atomic Punk
Unknown location – Grenna Base
Unknown location – Unidentified Alliance training base
Space stations
Expansion Region space stations
Hijoian system – Hijoian Docks
Mid Rim space stations
Bothan sector – Relay station
Doldur sector – Silver Station
Kashyyyk system – Rebel Outpost
Kothlis system – Kothlis II and Sentinel
Naboo system – Rebellion Remnants
Outer Rim space stations
Abrihom system – Abrihom
Dantooine system – Legacy YT Indigo Blue
Gelgelar system – Hormuuz
Generis system – Generis orbital base
Goff system – Goff
Mobetta system – Soren
Nocto system – Calenz
Outer Rim Territories – Freedom Station
Parmel system – DS 5
Tatoo system – Rebel Space Station
Unidentified planet – Rebel stronghold
Yavin system – Nova 3
Other space stations
A short hyperspace jump from Brint-wo Colony – Hospital
An asteroid field – Ring Base
Unknown location – AZ 77
Unknown location – Enin'sd
Unknown location – RS-32
Other bases
Ansarra Rebel base

This is a disambiguation page—a navigational aid that lists other pages that might otherwise share the same title. If an article link referred you here, you might want to go back and fix it to point directly to the intended page.





 